479x12xxx
x3x67xx1x
1x29xx7x4
xxxx4x568
68xxxxxx2
2xx863x9x
34xx8x9xx
x2x4xx8xx
8x152x4xx